{
    "rooms": [["s", "s", "s", "s", "s", "s", "s", "s", "s", "s", "s", "s", "s"],
              ["s",  0,   0,   0,   0,   0,  "s",  1,   1,   1,   1,   1,  "s"],
              ["s",  0,   0,   0,   0,   0,  "p",  1,   1,   1,   1,   1,  "s"],
              ["s",  0,   0,  "s",  0,   0,  "s", "s", "s", "s", "s",  1,  "s"],
              ["s",  0,   0,   0,   0,   0,  "p",  1,   1,   1,  "s",  1,  "s"],
              ["s",  0,   0,   0,   0,   0,  "s", "s", "s", "s", "s",  1,  "s"],
              ["s", "s", "s", "s", "s", "s", "s", "s", "s", "s", "s", "p", "s"],
              ["s",  3,   3,   3,   3,   3,  "s",  2,   2,   2,   2,   2,  "s"],
              ["s",  3,  "s",  3,  "s",  3,  "p",  2,   2,  "s", "s",  2,  "s"],
              ["s",  3,  "s",  3,   3,  "s", "s", "s",  2,  "s", "s",  2,  "s"],
              ["s",  3,  "s",  3,  "s",  3,  "p",  2,  "s",  2,   2,   2,  "s"],
              ["s",  3,  "s",  3,  "s",  3,  "s",  2,   2,   2,  "s", "s", "s"],
              ["s", "p", "s", "s", "s", "s", "s", "s", "s", "s", "s", "s", "s"],
              ["s",  4,   4,   4,   4,   4,  "s"],
              ["s",  4,   4,   4,   4,   4,  "s"],
              ["s",  4,  "s", "s", "s",  4,  "s"],
              ["s",  4,   4,   4,    4,  4,  "s"],
              ["s",  4,   4,   4,   4,   4,  "s"],
              ["s", "s", "s", "s", "s", "s", "s"]  
            ],
    "furniture": [[0,0,0,"sphere",0],[1,4,4,"triangleset",0]]
}
